15,6,0,
20,18,17,19,20,17,19,18,17,17,20,18,19,17,47,
35,34,33,35,36,33,35,34,33,33,36,34,35,33,63,
35,34,33,35,36,33,35,34,33,33,36,34,35,33,79,
35,34,33,35,36,33,35,34,33,33,36,34,35,33,63,
35,34,33,35,36,33,35,34,33,33,36,34,35,33,79,
35,34,33,35,36,33,35,34,33,33,36,34,35,33,95,
