15,9,0,
46,18,17,19,20,17,19,18,17,17,20,18,19,17,47,
62,34,33,35,36,33,35,34,33,33,36,34,35,33,63,
78,34,33,35,36,33,35,34,33,33,36,34,35,33,79,
62,34,33,35,36,33,35,34,33,33,36,34,35,33,95,
78,34,33,35,36,33,35,34,33,33,36,34,35,33,34,
62,34,33,35,36,33,35,34,33,33,36,34,35,33,34,
78,34,33,35,36,33,35,34,33,33,36,34,35,33,34,
62,34,33,35,36,33,35,34,33,33,36,34,35,33,34,
94,34,33,35,36,33,35,34,33,33,36,34,35,33,34,
